resources\grassworld_spritesheet.png
x,x x,x x,x x,x x,x x,x x,x x,x x,x x,x x,x x,x x,x x,x x,x x,x x,x x,x x,x x,x x,x x,x x,x x,x x,x x,x x,x x,x x,x x,x x,x x,x x,x x,x x,x
x,x x,x x,x x,x x,x x,x x,x x,x x,x x,x x,x x,x x,x x,x x,x x,x x,x x,x x,x x,x x,x x,x x,x x,x x,x x,x x,x x,x x,x x,x x,x x,x x,x x,x x,x
x,x x,x x,x x,x x,x x,x x,x x,x x,x x,x x,x x,x x,x x,x x,x x,x x,x x,x x,x x,x x,x x,x x,x x,x x,x x,x x,x x,x x,x x,x x,x x,x x,x x,x x,x
1,0 1,0 1,0 1,0 1,0 1,0 2,0 x,x x,x x,x x,x x,x 0,0 1,0 1,0 1,0 1,0 2,0 x,x x,x x,x x,x x,x x,x x,x x,x x,x x,x 3,0 x,x x,x x,x x,x x,x x,x
1,1 1,1 1,1 1,1 1,1 1,1 2,1 x,x x,x x,x x,x x,x 0,1 1,1 1,1 1,1 1,1 2,1 x,x x,x x,x x,x x,x x,x x,x x,x x,x x,x 3,1 x,x x,x x,x x,x x,x x,x
1,2 1,2 1,2 1,2 1,2 1,2 2,2 x,x x,x x,x x,x x,x 0,2 1,2 1,2 1,2 1,2 2,2 x,x x,x x,x x,x 3,0 x,x x,x x,x x,x x,x 3,1 x,x 3,0 x,x x,x x,x x,x
x,x x,x x,x x,x x,x x,x x,x x,x x,x x,x x,x x,x x,x x,x x,x x,x x,x x,x x,x x,x x,x x,x 3,1 x,x x,x x,x x,x x,x 3,1 x,x 3,1 x,x x,x x,x x,x
x,x x,x x,x x,x x,x x,x x,x x,x x,x x,x x,x x,x x,x x,x x,x x,x x,x x,x x,x x,x x,x x,x x,x x,x x,x x,x x,x x,x 3,1 3,0 3,1 x,x x,x x,x x,x
x,x x,x x,x x,x x,x x,x x,x x,x x,x x,x x,x x,x x,x x,x x,x x,x x,x x,x x,x x,x x,x x,x x,x x,x x,x x,x x,x x,x 3,1 3,1 3,1 x,x x,x x,x x,x
x,x x,x x,x x,x x,x x,x x,x x,x x,x x,x x,x x,x x,x x,x x,x x,x x,x x,x x,x x,x x,x x,x x,x x,x x,x x,x x,x x,x 3,1 3,1 3,1 x,x x,x x,x x,x
x,x x,x x,x x,x x,x x,x x,x x,x x,x x,x x,x x,x x,x 3,0 x,x x,x x,x x,x x,x 3,0 x,x x,x x,x x,x x,x 0,0 1,0 1,0 1,0 1,0 1,0 2,0 x,x x,x x,x
x,x x,x x,x x,x x,x x,x x,x x,x 3,0 x,x x,x x,x x,x 3,1 x,x x,x x,x x,x x,x 3,1 x,x x,x x,x x,x x,x 0,1 1,1 1,1 1,1 1,1 1,1 2,1 x,x x,x x,x
x,x x,x x,x x,x x,x x,x x,x x,x 3,1 x,x x,x x,x x,x 3,1 x,x x,x x,x x,x x,x 3,1 x,x x,x x,x x,x x,x 0,2 1,2 1,2 1,2 1,2 1,2 2,2 x,x x,x x,x
x,x x,x x,x x,x x,x x,x x,x x,x 3,1 x,x x,x x,x x,x 3,1 x,x x,x x,x x,x x,x x,x x,x x,x x,x x,x x,x x,x x,x x,x x,x x,x x,x x,x x,x x,x x,x
x,x x,x x,x x,x 3,0 x,x x,x x,x 3,1 x,x x,x x,x x,x 3,1 x,x x,x x,x x,x x,x x,x x,x x,x x,x x,x x,x x,x x,x x,x x,x x,x x,x x,x x,x x,x x,x
x,x x,x x,x x,x 3,1 x,x x,x x,x 3,1 x,x x,x x,x x,x 3,1 x,x x,x x,x x,x x,x x,x x,x x,x x,x x,x x,x x,x x,x x,x x,x x,x x,x x,x x,x x,x x,x
x,x x,x x,x 3,0 3,1 x,x x,x x,x 3,1 x,x x,x x,x x,x 3,1 x,x x,x x,x x,x x,x x,x x,x x,x x,x x,x x,x x,x x,x x,x x,x x,x x,x x,x x,x x,x x,x
x,x x,x x,x 3,1 3,1 x,x x,x x,x 3,1 x,x x,x x,x x,x 3,1 x,x x,x x,x x,x x,x x,x x,x x,x x,x x,x x,x x,x x,x x,x x,x x,x x,x x,x x,x x,x x,x
x,x x,x x,x 3,1 3,1 x,x x,x x,x 3,1 x,x x,x x,x x,x 3,1 x,x x,x x,x x,x x,x x,x x,x x,x x,x x,x x,x x,x x,x x,x x,x x,x x,x x,x x,x x,x x,x
x,x x,x x,x 3,1 3,1 3,0 x,x x,x 3,1 x,x x,x x,x x,x 3,1 x,x x,x x,x x,x x,x x,x x,x x,x x,x x,x x,x x,x x,x x,x x,x x,x x,x x,x x,x x,x x,x
x,x x,x x,x 3,1 3,1 3,1 x,x x,x 3,1 x,x x,x x,x x,x 3,1 x,x x,x x,x x,x x,x x,x x,x x,x x,x x,x x,x x,x x,x x,x x,x x,x x,x x,x x,x x,x x,x
x,x x,x x,x 3,1 3,1 3,1 x,x x,x 3,1 x,x x,x x,x x,x 3,1 x,x x,x x,x x,x x,x x,x x,x x,x x,x x,x x,x x,x x,x x,x x,x x,x x,x x,x x,x x,x x,x
x,x x,x x,x 3,1 3,1 3,1 x,x x,x 3,1 x,x x,x x,x 0,0 1,0 2,0 x,x x,x x,x x,x 3,0 x,x x,x x,x x,x 3,0 x,x x,x x,x x,x x,x 0,0 1,0 1,0 1,0 1,0
x,x x,x x,x 3,1 3,1 3,1 x,x x,x 3,1 x,x x,x x,x 0,1 1,1 2,1 x,x x,x x,x x,x 3,1 x,x x,x x,x x,x 3,1 x,x x,x x,x x,x x,x 0,1 1,1 1,1 1,1 1,1
x,x x,x x,x 3,1 3,1 3,1 x,x x,x 3,1 x,x x,x x,x 0,1 1,1 2,1 x,x x,x x,x x,x 3,1 x,x x,x x,x x,x 3,1 x,x x,x x,x x,x x,x 0,1 1,1 1,1 1,1 1,1
x,x x,x x,x 3,1 3,1 3,1 x,x x,x 3,1 x,x x,x x,x 0,1 1,1 2,1 x,x x,x x,x x,x 3,1 x,x x,x x,x x,x 3,1 x,x x,x x,x x,x x,x 0,1 1,1 1,1 1,1 1,1